. . . . . . # . . .
# . # # . . . . # .
. . . . . . # . . #
. # # . . . . . . .
. # # # . . . . # .
. . . . . . . . . .
. # . . . . . . # #
# . . . . . . . # #
. . . . . . . . . .
# . . . . . # . # .
